5
  \\ 
 /#/ 
 #   
#  # 
    %

+---------+---------+
|  \\ //  |  \\ //  |
| /#/ \#\ | /#/ \#\ |
| #     # | #     # |
|#  # #  #|#  # #  #|
|    %    |    %    |
|#  # #  #|#  # #  #|
| #     # | #     # |
| \#\ /#/ | \#\ /#/ |
|  // \\  |  // \\  |
+---------+---------+
|  \\ //  |  \\ //  |
| /#/ \#\ | /#/ \#\ |
| #     # | #     # |
|#  # #  #|#  # #  #|
|    %    |    %    |
|#  # #  #|#  # #  #|
| #     # | #     # |
| \#\ /#/ | \#\ /#/ |
|  // \\  |  // \\  |
+---------+---------+
