10 5
##########
#S.......#
##.#####.#
##.#.....#
##########

##########
#01234567#
##2#####8#
##3#DCBA9#
##########
